#w##w###w##
#.........#
#.#.....#.#
#.........#
#...@..#..#
#.........d
#.........#
#.........#
#.#....#..#
#.........#
###########