######w########ww####ww#####
##..@....................###
##...........#####...#######
##################.........d
.................###########